die Katze	die Katzen
der Hund	die Hunde
der Onkel	die Onkel
die Tante	die Tanten
der Vater	die Väter
die Mutter	die Mütter
der Mann	die Männer
die Frau	die Frauen
der Junge	die Jungen
der Bauer	die Bauern
die Kuh	die Kühe
der Arzt	die Ärzte
das Ding	die Dingen
das Haus	die Häuser
das Kind	die Kinder
der Kopf	die Köpfe
die Armee	die Armeen
die Dame	die Damen
die Stadt	die Städte
das Labor	die Labore
