de kat	de katten
de hond	de honden
de tante	de tantes
de vader	de vaders
de moeder	de moeders
de man	de mannen
de vrouw	de vrouwen
de jongen	de jongens
de boer	de boeren
de doktor	de doktoren
de koe	de koeien
de zanger	de zangers
de acteur	de acteurs
de groep	de groepen
de stad	de steden
de leraar	de leraren
de beer	de beren
de schrijver	de schrijvers
de ober	de obers
de koning	de koningen
