le chat	les chats
le chien	les chiens
le rat	les rats
le loup	les loups
la vache	les vaches
la mère	les mères
l' homme	les hommes
la femme	les femmes
le garçon	les garçons
la fille	les filles
l' ami	les amis
la chose	les choses
le monde	les mondes
la maison	les maisons
l' œil	les yeux
la tête	les têtes
le groupe	les groupes
l' armée	les armées
l' enfant	les enfants
la ville	les villes