de atleet	de atleten
de oom	de ooms
de tante	de tantes
de vader	de vaders
de moeder	de moeders
de man	de mannen
de vrouw	de vrouwen
de jongen	de jongens
de boer	de boeren
de doktor	de doktoren
de crimineel	de criminelen
de zanger	de zangers
de acteur	de acteurs
de actrice	de actrices
de secretaris	de secretarissen
de professor	de professoren
de timmerman	de timmermannen
de schrijver	de schrijvers
de ober	de obers
de koning	de koningen
