le sportif	les sportifs
la sportive	les sportives
l' oncle	les oncles
la tante	les tantes
le père	les pères
la mère	les mères
l' homme	les hommes
la femme	les femmes
le garçon	les garçons
la fille	les filles
l' agriculteur	les agriculteurs
le médecin	les médecins
le criminel	les criminels
la chanteuse	les chanteuses
la victime	les victimes
l' actrice	les actrices
le secrétaire	les secrétaires
le professeur	les professeurs
l' enfant	les enfants
le charpentier	les charpentiers
le beau	les beaux
