der Athlet	die Athleten
die Athletin	die Athletinnen
der Onkel	die Onkel
die Tante	die Tanten
der Vater	die Väter
die Mutter	die Mütter
der Mann	die Männer
die Frau	die Frauen
der Junge	die Jungen
der Bauer	die Bauern
der Doktor	die Doktoren
der Arzt	die Ärzte
der Kriminelle	die Kriminellen
der Professor	die Professoren
das Kind	die Kinder
der Zimmermann	die Zimmerleute
der Assistent	die Assistenten
die Dame	die Damen
die Sekretärin	die Sekretärinnen
der Bruder	die Brüder